Check the <b>closet</b>.	a small room or a space in a wall with a door that reaches the floor, used for storing things  衣帽间	toeic
a sports <b>stadium</b>	a large sports ground surrounded by rows of seats and usually other buildings  运动场	toeic
buildings in need of <b>renovation</b>	to repair and paint an old building, a piece of furniture, so that it is in good condition again  修复，翻新	toeic
They're offering a 10% <b>discount</b> on all sofas this month.	an amount of money that is taken off the usual cost of sth  折扣	toeic
an amount of money that is <b>taken</b> <b>off</b> the usual cost of sth	to remove an amount of money or a number of marks, points, etc. in order to reduce the total  扣除	toeic
money-off <b>coupons</b>	a small piece of printed paper that you can exchange for sth or that gives you the right to buy sth at a cheaper price than normal  优惠券	toeic
None of them could sing <b>in</b> <b>tune</b>.	在调上	toeic
<b>Work extra hours</b>	加班	toeic
my high school <b>orchestra</b>	a large group of people who play various musical instruments together, led by a conductor  管弦乐队	toeic
<b>sign</b> <b>up</b>	to arrange to do a course of study by adding your name to the list of people doing it  报名	toeic
metal <b>bookcase</b>	a piece of furniture with shelves for keeping books  书架	toeic
<b>vinyl</b> chair	a strong plastic that can bend easily, used for making wall, floor, and furniture coverings, book covers, and, especially in the past, records  塑料（乙烯基）	toeic
a <b>stationery</b> store	materials for writing and for using in an office, for example paper, pens and envelopes  文具	toeic
look at the <b>graphic</b>	a diagram or picture, especially one that appears on a computer scree or in a newspaper or book （尤其指电脑荧屏或报纸，书籍上的）图形，图表	toeic
our first-floor <b>lounge</b>	a room for waiting in at an airport, etc.  等候室	toeic
According to the <b>flyer</b>	a small sheet of paper that advertises a product or an event and is given to a large number of people  传单	toeic
She made a <b>favorable</b> impression on his parents.	making people have a good opinion of sb/sth  良好的（印象）	toeic
<b>wood shavings</b>	木屑	toeic
customer service <b>representative</b>	a person who has been chosen to speak or vote for sb else or on behalf of a group  代表	toeic
This is a matter of the <b>utmost</b> importance.	greatest; most extreme  最大的，极度的	toeic
<b>indistinct</b>	that cannot be seen, heard or remembered clearly  模糊不清的	toeic
The school pays for heating and the <b>maintenance</b> of the buildings.	the act of keeping sth in good condition by checking or repairing it regularly  维护	toeic
in the <b>warehouse</b>	a building where large quantities goods are stored, especially before they are sent to shops or stores to be sold  仓库	toeic
<b>ceiling</b>	the top inside surface of a room  天花板	toeic
in the <b>basement</b>	a room or rooms in a building, partly or completely below the level of the ground  地下室	toeic
a <b>shipment</b> of arms	a load of goods that are sent from one place to another  运输的货物	toeic
The store sells women's and children's <b>apparel</b>.	clothing, when it is being sold in shops/stores  （商店里销售的）衣服	toeic
career opportunities in <b>tetailing</b>	the business of selling goods to the public, usually through shops/stores  零售业	toeic
a wide selection of <b>merchandise</b>	goods that are for sale in a shop/store  商品	toeic
The company's annual <b>revenues</b> rose by 30%.	the money that a government receives from taxes or that an organization, etc. receives from its business  收入，收益	toeic
the president's <b>consultant</b> on economic affairs	a person who knows a lot about a particular subject and is employed to give advice about it to other people  顾问	toeic
personal <b>finances</b>	the money available to a person, an organization or a country （个人、组织、国家的）财力  形容“财力”只能用的复数形式finances	toeic
a <b>mug</b> of coffee	a mug and what is contains  一缸子（的量）“mug”就是我们平时说的“马克杯”	toeic
to <b>renew</b> a subscription	to make sth valid for a further period of time  延长...的期限	toeic
to write a <b>check</b>	is equal to 'cheque', which means a printed form that you can write on and sign as a way of paying for sth instead of using money  支票	toeic
<b>antique</b> autos	old and often valuable  古老的。这个短语的意思是“老爷车”	toeic
He has been awarded a research <b>grant</b>.	a sum of money that is given by the government or by another organization to be used for a particular purpose  （政府，机构等的）拨款	toeic
