Barbecues are a favourite way of <b>entertaining</b> friends.	entertain:  to invite people to eat or drink with you as your guests, especially in your home （尤指在自己家中）招待，款待
the company's sales <b>division</b>	a large and important unit or section of an organization  （公司的）部门。这个短语的意思是：“<b>公司的销售部门</b>”
a hotel <b>lobby</b>	a large area inside the entrance of a public building where people can meet and wait  （公共建筑物进口处的）门厅
a wedding <b>reception</b>	a formal social occasion to welcome sb or celebrate sth  接待仪式
He was in London <b>publicizing</b> his new biography of Kennedy.	publicize:  to make sth known to the public; to advertise sth  宣传，推广
Do not use this substance in an <b>enclosed</b> space.	with walls, etc. all aroud  （用墙等）围起来
He has been an active <b>participant</b> in the discussion.	a person who is taking part in an activity or event 参与者
<b>complimentary</b> breakfast	given free 免费的
A <b>shuttle</b> service between London and Edinburgh.	a plane, bus or train that travels regularly between two places  来往于两地的航班（或班车，火车）
Are you <b>suggesting</b> that I'm lazy?	suggest:  to state sth indirectly; imply  暗含，暗示
Would you type up <b>the</b> <b>minutes</b> from today's staff meeting?	a summary or record of what is said or decided at a formal meeting  会议记录
I'd like to discuss the project you just <b>turned</b> <b>in</b>.	to give sth to sb in authority  上交
<b>Could it wait until tomorrow</b>?	能等到明天吗？
<b>labeling</b> <b>machine</b>	可以自动贴标签的机器，<b>贴标机</b>
Our skin cream contains only natural <b>ingredients</b>.	ingredient:  one of the things from which sth is made, especially one of the foods that are used together to make a particular dish  成分
The report <b>highlights</b> the major advantages of this merchandise.	highlight:  to emphasize sth, especially so that people give it more attention  突出，强调
washable <b>fabric</b>	material made by cotton, silk, etc. used for making colthes, curtains, etc. and for covering furniture  面料
loading <b>dock</b>	a raised platform for loading vehicles or trains  （供运货汽车或铁路货车装卸货物的）月台
Where should I put the large <b>envelopes</b>?	envelope:  信封
A <b>printout</b> of text downloaded from the Internet.	a page or set of pages containing information in printed form from a computer  （计算机）打印件
Work <b>shifts</b> are assigned.	shift:  a period of time worked by a group of workers who start work as another group finishes  班次
<b>leftover</b> supplies	an object, a custom or a way of behaving that remains from an earlier time  遗留物。这个短语的意思是：“剩余的（办公）耗材”
<b>I can stop by around 9:00 A.M.</b> Does that work for you?	<b>我可以在上午9：00左右过去</b>
a <b>cosmetic</b> company	a substance that you put on your face or body to make it more attractive  化妆品
<b>Art</b> <b>supplies</b>	美术用品
<b>organic</b> foods	produced or practised without artificial chemicals	有机的
<b>Home</b> <b>goods</b>	家居用品
I appreciate you coming my apartment <b>at such short notice</b>	<b>在这么短的时间内</b>
a <b>puddle</b> of water	a small amount of water or other liquid, especially rain, that has collected in one place on the ground 小水洼
<b>a maintenance worker</b>	维修工
<b>a real estate agent</b>	房产经纪人
