<b>agile</b> software development	able to move quickly and easily  （动作）敏捷的，灵活的	LongTermLearning
<b>By the way</b>, I found that book you were looking for.	used to introduce a comment or question that is not directly related to what you have talking about  顺便提一下	LongTermLearning
<b>It is often the case</b> that a program cannot determine that it hasread enough input until it has read too much.	...通常是...的情况	LongTermLearning
They managed to <b>shoehorn</b> the material onto just one CD.	to succeed in pustting sth into a small space or a palce where it does not fit very easily  把...硬塞进	LongTermLearning
He <b>bragged</b> to his friends about his Farrari.	to talk too proudly about sth you own or sth you have done  吹嘘，自吹自擂	LongTermLearning
There was a real <b>scrum</b> when the bus arrived.	a crowd of people who are pushing each other  相互拥挤的人群	LongTermLearning
<b>erroneous</b> conclusions	not correct; based on wrong information  错误的	LongTermLearning
He eventually <b>found his way into</b> acting.	to come to a place or a situation by chance or without intending to  偶然来到，无意中竟处于...	LongTermLearning
I see this almost as a <b>tautology</b>.	a statement in which you say the same thing twice in different words, when this is unnecessary, for example "They spoke in turn, one after the other." 赘述	LongTermLearning
If you want to succeed in business you have to <b>suss out</b> the competition.	to realize sth; to understand the important things about sb/sth  意识到，这里可以理解为“figure out”	LongTermLearning
a <b>fruitless</b> attempt	producing no useful results 徒然的	LongTermLearning
Please make every <b>endeavour</b> to arrive on time.	an attempt to do sth, especially sth new or difficult  （尤指新的或艰苦的）努力，尝试	LongTermLearning
a <b>hunk</b> of bread	a large piece of sth, especially food, that has been cut or broken from a larger piece  （尤其指食物切下的掰下的）大块，大片	LongTermLearning
<b>Benevolent</b> dictator for life (BDFL)	（especially of people in authority）慈善的，行善的	LongTermLearning
Benevolent <b>dictator</b> for life (BDFL)	a person who behaves as if they have complete power over other people, and tells them what to do 专横的人	LongTermLearning
<b>copilot</b>	a second pilot who helps the main pilot in an aircraft  （飞机的）副驾驶员	LongTermLearning
He confessed after four days under <b>interrogation</b>.	to ask sb a lot of questions over a long period of time, especially in an aggressive way  讯问，审问	LongTermLearning
He was <b>in and out of</b> jail for most of his life.	going regularly to a place 时常出入	LongTermLearning
She's <b>hesitant</b> about signing the contract.	slow to speak or act because you feel uncertain, embarrassed or unwilling  犹豫的，不情愿的	LongTermLearning
a sudden <b>burst</b> of energy	a short period of a particular activity or strong emotion that often starts suddenly  突发，爆发	LongTermLearning
She <b>summoned</b> the waiter.	to order sb to come to you  召唤	LongTermLearning
the Yorkshire <b>dialect</b>	the form of a language that is spoken in one area with grammar, words and pronunciation that may be different from other forms of the same language  方言,地方话	LongTermLearning
Our objectives need to be precisely <b>delineate</b>.	to describe, draw, or explain sth in detail  （详细地）描述	LongTermLearning
