A <b>curated</b> list of awesome Go frameworks.	to select organize and look after the objects or works of art in a museum or art gallery, etc.  管理。这里是形容词，意思是“管理的”
<b>capture</b>	to put sth into a computer in a form it can use 把……输入计算机，采集
A <b>voracious</b> reader	wanting a lot of new information and knowledge （对信息、知识）渴求的
He seems to have <b>overlooked</b> one important fact.	overlook:  to fail to see or notice sth  忽略
Should I drop a <b>hint</b> to Matt?	something that you say or do in an indirect way in order to show sb what you are thinking  暗示
A <b>whirlwind</b> tour of Python	happening very fast 快速的，匆匆忙忙的
<b>nomenclature</b>	a system of naming things, especially in a branch of science  （尤指某学科的）命名方法
<b>prime</b> <b>number</b>	a number that can be divided exactly only by itself and 1 素数
the many <b>anomalies</b> in the tax system	<b>anomaly</b>:  a thing, situation, etc. that is different from what is normal or expected 异常现象
course <b>syllabus</b>	a list of the topics, books, etc. that students should study in a particular subject at school or college 教学大纲
<b>rolling</b> <b>a die</b>	摇色子
<b>dice</b>	色子
<b>lumberjack</b>	(especially in the US and Canada) a person whose job is cutting down trees or cutting or transporting wood （尤指美国和加拿大的）伐木工人
We had to make a <b>detour</b> around the flooded fields.	a longer route that you take in order to avoid a problem or to visit a place  绕路
It was a shock to discover the truth about his <b>sordid</b> past.	immoral or dishonest  卑鄙的，丑恶的
a <b>fruitful</b> collaboration	producing many useful results  富有成效的
a <b>pragmatic</b> approach to management problems	solving problems in a practical and sensible way rather than by having fixed ideas or theories  实用的，讲求实效的
The meal was <b>ridiculously</b> expensive.	very silly or unreasonable  愚蠢的，荒谬的
a <b>reassuring</b> smile	making you feel less worried or uncertain about sth  令人放心的
Would you care to <b>partake</b> <b>of</b> some refreshment?	to eat or drink sth especially sth that is offered to you 吃，喝（别人给人的东西）
