<b>thermal</b> throttling	connected with heat  热的，热量的  这个短语是一个科技用语，意思是“当计算机温度过高时，它的性能就会下降”	LongTermLearning
We made a short <b>diversion</b> to go and look at the castle.	the act of changing the direction that sb/sth is following, or what sth is used for  转向，偏移	LongTermLearning
<b>Phew</b>, I'm glad that's all over.	<b>phew</b>:  a sound that people make to show that they are hot, tried, or happy that sth bad has finished or did not happen.  哦（表示热，累或宽慰）	LongTermLearning
She has the <b>daunting</b> task of cooking for 20 people every day.	daunt:  to make sb feel nervous and less confident about doing sth  使胆怯，使气馁	LongTermLearning
Whole villages were <b>wiped out</b> by the earthquake.	<b>wipe out</b>:  to destory or remove sb/sth completely  彻底消灭	LongTermLearning
full <b>disclosure</b>	the act of making sth known or public that was previously secret or private  揭露，公开	LongTermLearning
What is the <b>rationale</b> behind these new exams?	the principles or reasons which explain a particular decision, course of action, belief, etc.  基本原理，根本原因	LongTermLearning
This recipe is <b>foolproof</b> -- it works every time.	(of a plan, machine, method, etc.) very well designed and easy to use so that it cannot fail and you cannot use it wrongly  万无一失的	LongTermLearning
The new road building programme has been <b>ditched</b>.	to get rid of sth/sb because you no longer want or need it/them  摆脱	LongTermLearning
a <b>disastrous</b> result	very bad, harmful or unsuccessful 极糟糕的	LongTermLearning
Last year's riots <b>pale in comparison with</b> this latest outburst of violence.	to seem less important when compared with sth else  与……相比显得相形见绌	LongTermLearning
Reporters <b>intercepted</b> him as he tried to leave the hotel.	intercept:  to stop sb/sth that is going from one place to another from arriving  拦截	LongTermLearning
<b>meme</b>	a type of behaviour that is passed from one member of a group to another, not in the GENEs but by another means such as people copying it  模因，模仿传递行为（通过模仿等非基因方式传递的行为）	LongTermLearning
<b>backbone</b>	the row of small bones that are connected together down the middle of the back  脊柱，脊梁骨	LongTermLearning
<b>Here's the catch</b>.	这个短语的意思是“这就是问题所在”	LongTermLearning
<b>accursed</b>	having a curse on it 受诅咒的	LongTermLearning
<b>profane</b> love	not connected with religion or holy things  世俗的	LongTermLearning
to give <b>utterance</b> to your thoughts	the act of expressing sth in words  用言语表达出来	LongTermLearning
the company's first <b>foray</b> into the computer market	an attempt to become involved in a different activity or profession  （改变职业、活动的）尝试	LongTermLearning
Could you turn the sound down just a <b>tad</b>?	a very small amount  少量，一点儿	LongTermLearning
It's purely <b>coincidental</b> that we both chose to call our daughters Emma.	happening by chance; not planned  巧合	LongTermLearning
She <b>blurted</b> it <b>out</b> before I could stop her.	blurt it out:  to say sth suddenly and without thinking carefully enough  脱口而出	LongTermLearning
I <b>bust</b> my camera.	to break sth  摔坏	LongTermLearning
He doesn't have the <b>guts</b> to walk away from a well-paid job.	the courage and determination that it takes to do sth difficult or unpleasant  勇气	LongTermLearning
<b>workhorse</b>	a person or machine that you can rely on to do hard and/or boring work  埋头苦干的人	LongTermLearning
They're <b>prepping</b> for college.	prep:  to prepare  把……准备好	LongTermLearning
I do it <b>just for kicks</b>.	just for fun	LongTermLearning
<b>pesky</b> insects	annoying 恼人的	LongTermLearning
They refused to <b>comply</b> with the UN resolution.	to obey a rule, an order, etc. 遵从，服从	LongTermLearning
to pass an <b>resolution</b>	a formal statement of an opinion agreed on by a committee or a council, especially by means of a vote  决议	LongTermLearning
A copy of the report is available for you to <b>peruse</b> at your leisure.	to read sth, especially in a careful way  细读，研读	LongTermLearning
She drove off at a <b>furious</b> pace.	with great energy, speed or anger  激烈的，高速的	LongTermLearning
This fine and <b>dandy</b>.	very good  极佳的	LongTermLearning
<b>amigo</b>	西班牙语地区“朋友”的意思	LongTermLearning
I got the inside <b>scoop</b> on his new girl-friend.	the latest information about sb/sth, especially details that are not generally known （鲜为人知的）最新消息	LongTermLearning
political groups <b>agitating</b> for social change	<b>agitate</b>:  to argue strongly for sth you want, especially for changes in a law, in social conditions, etc.  （尤其指为法律，社会状况的改变而）激烈争论，鼓动，煽动	LongTermLearning
