And the option specifies this in a particular <b>arcane</b> way.	secret and mysterious and therefore difficult to understand 神秘的
<b>competency</b>	competence  能力
Blonde hair <b>cascaded</b> over her shoulders.	to fall or hang in large amounts  大量落下，大量垂悬
<b>singularity</b>	the quality of sth that makes it unusual or strange 奇特，奇怪
The company needs to <b>leverage</b> its resources.	to get as much advantage or profit as possible from sth that you have  充分利用
A single light bulb <b>dangled</b> from the ceiling.	to hang or swing freely  悬挂，悬摆
A single light <b>bulb</b> dangled from the ceiling.	the glass part that fits into an electric lamp, etc. to give light when it is switched on 电灯泡
A single light bulb dangled from the <b>ceiling</b>.	the top inside surface of a room  天花板
Her latest novel was <b>dissected</b> by the critics.	to study sth closely and/or discuss it in great detail  仔细研究
They are now <b>reaping</b> the rewards of all their hard work.	to obtain sth, especially sth good, as a direct result of sth that you have done. 取得（成果），收获
Don't <b>clutter</b> the page <b>with</b> too many diagrams.	to fill a place with too many things, so that it is untidy  凌乱地塞满
I mention it only as an <b>aside</b>.	a remark that is not directly connected with the main subject that is being discussed  离题话
The theory has been <b>superseded</b> by more recent research.	to take the place of sth/sb that is considered to be old-fashioned or no longer the best available  取代，替代
In modern <b>parlance</b>	a particular way of using words or expressing yourself, for example one used by a particular group  说法，术语
Much of the form was not <b>applicable</b> to me.	that can be said to be true in the case of sb/sth  适用，合适
to <b>resolve</b> an issue	to find an acceptable solution to a problem or difficulty  解决（问题或困难）
The job <b>entails</b> a lot of hard work.	to involve sth that cannot be avoided  需要，使必要
<b>semantically</b> related words	connected with the meaning of words and sentences  语义地
That's <b>precisely</b> what I meant.	exactly  准确地
He made some minor <b>revisions</b> to the report before printing it out.	a change or set of changes to sth  （一项，一轮等）修订，修改
