If you really believe that software is <b>subservient</b> to the outcome, you'll be ready to really find "the right tool for the job" which might not be software at all.	less important than sth else  次要的，从属于...，这里是“次要的”意思	LongTermLearning
The primary job of any software engineer is delivering value. Very few software developers understand this, even fewer <b>internalize</b> it.	to make a feeling, an attitude, or a belief part of the way you think and behave  使（感情、态度或信仰）成为思想行为的一部分；<b>使内在化</b>	LongTermLearning
It <b>amounts</b> <b>to</b> a lot more than just lost engineering time.	to add up to sth; to make sth as a total  总计，共计	LongTermLearning
You ask someone in any profession how to solve a problem, and they are going to <b>err on the side of</b> what they are good at.	to show too much of a good quality  过于（展现一些好的品质）	LongTermLearning
She has been looking after the <b>day-to-day</b> running of the school.	involving the usual events or tasks of each day  日常工作的，例行的	LongTermLearning
One example will <b>suffice</b> to illustrate the point.	to be enough for sb/sth  足够，足以	LongTermLearning
<b>rule of thumb</b>	经验之谈	LongTermLearning
<b>toxic</b> substance	containing poison; poisonous 有毒的	LongTermLearning
Innocent passers-by <b>got caught up</b> in the riots.	to become involved in sth, especially when you do not want to be 被卷入，陷入	LongTermLearning
<b>paralysis</b> of both legs	瘫痪，麻痹	LongTermLearning
<b>apt to</b> be forgetful	likely or having a natural tendency to do sth  易于...，有...的倾向	LongTermLearning
They failed to <b>grasp</b> the importance of his words.	to understand sth completely 理解，领悟	LongTermLearning
the moral <b>universe</b>	a set of experiences of a particular type  （某种）经验体系	LongTermLearning
Be <b>wary</b> of strangers who offer you a ride.	careful when dealing with sb/sth because you think that there may be a danger or problem  （对等人或事物）小心的，谨慎的	LongTermLearning
She likes to <b>keep up with</b> the latest fashions.	to learn about or be aware of the news, current events, etc.  熟悉，了解（消息，形势等）	LongTermLearning
Make sure the firm is <b>competent</b> to carry out the work.	having enough skill or knowledge to do sth well or to the necessary standard  足以胜任的	LongTermLearning
He doesn't particularly like the work but he sees it as <b>a means to an end</b>.	a thing or action that is not interesting or important in itself but is a way of achieving sth else （本身并不重要或有趣的）达到目的的手段	LongTermLearning
Don't just <b>sling</b> your clothes on the floor.	to throw sth somewhere in a careless way （随便地）扔，丢	LongTermLearning
What's the best way of <b>approaching</b> this problem?	to start dealing with a problem, task, etc. in a particular way 着手处理	LongTermLearning
Don't mistake <b>humility</b> for ignorance.	the quality of not thinking that you are better than other people; the quality of being humble  谦逊，谦虚	LongTermLearning
stepfather	the man who is married to your mother but who is not your real father  继父	LongTermLearning
The first writer I watched <b>at work</b> was my stepfather.	having an effect on sth  起作用	LongTermLearning
He was required to <b>file</b> a few hundred words of editorial or personal commentary on some topic in or out of the news that week.	to send a report or a story to your employer  发送（报道给报社）	LongTermLearning
an <b>editorial</b> decision	connected with the task of preparing sth such as a newspaper, a book or a television or radio programme, to be published or broadcast  编辑的。这句话的意思是“稿件取舍决定”	LongTermLearning
He was required to file a few hundred words of editorial or personal <b>commentary</b> on some topic in or out of the news that week.	a written explanation or discussion of sth such as a book or a play  评论，评注，是别人给某种事物的评论，而“comment”是当事人给事物的评论	LongTermLearning
