a <b>ruthless</b> dictator	ruthless:  (of people or their behaviour) hard and cruel; detemined to get what you want and not caring if you hurt other people 残酷无情的	LongTermLearning
He <b>counselled</b> them to give up the plan.	counsel:  to advise sb to do sth  建议	LongTermLearning
Their marriage is under great <b>strain</b> at the moment.	strain:  pressure on sb/sth because they have too much to do or manage, or sth very difficult to deal with  压力	LongTermLearning
a <b>dispute</b> between the two countries about the border	dispute:  an argument or a disagreement between two people, groups or countries  争论	LongTermLearning
My mother's hospital expenses were slowly <b>draining</b> my income.	drain:  to make sb/sth weaker, poorer, etc. by using up their/its strength, money, etc.  耗尽	LongTermLearning
'Pass away' is <b>euphemism</b> for 'die'.	euphemism:  an indirect word or phrase that people often use to refer to sth embarrassing or unpleasant, sometimes to make it seem more acceptable than it really is  委婉语	LongTermLearning
She was accused of <b>withholding</b> information from the police.	withhold:  to refuse to give sth to sb  拒绝给，不给	LongTermLearning
And as tough as they might have found his advice at the time, founders always wind up thanking him for his <b>candor</b>.	candor:  the quality of saying what you think openly and honestly   真诚	LongTermLearning
The speaker was just <b>winding up</b> when the door was flung open.	wind up:  to bring sth such as a speech or meeting to an end  结束（讲话，会议）这句话的意思是：演讲者刚要结束讲话时，门突然被推开了 PS:  flung 是 fling 的过去分词，意思是：用力地推	LongTermLearning
the company's <b>fiduciary</b> duty to its shareholders	fiduciary:  involving trust, especially in a situation where a person or company controls money or property belonging to others  受托的。这句话的意思是：公司对股东负有受托责任	LongTermLearning
They had only a <b>vague</b> idea where the place was.	vague:  not clear in a person's mind  （思想上）含糊不清的，模糊的	LongTermLearning
a <b>benevolent</b> simle	benevolent:  (especially of people in authority) kind, helpful, and generous  慈善的	LongTermLearning
<b>maternal</b> love	maternal:  having feelings that are typical of a caring mother towards a child  母亲的。这个短语的意思是：母爱	LongTermLearning
The male bird has <b>distinctive</b> white markings on its head.	distinctive:  having a quality or characteristic that makes sth different and easily noticed  独特的	LongTermLearning
These claims are absolutely <b>preposterous</b>!	preposterous:  completely unreasonable, especially in a way that is shocking and annoying 荒唐的	LongTermLearning
Pour the chocolate into a heart-shaped <b>mold</b>.	mold:  a container that you pour a liquid or soft substance into, which then becomes solid in the same shape as the container 模具	LongTermLearning
You need <b>nimble</b> fingers for that job.	nimble:  able to move quickly and easily  灵活的	LongTermLearning
an <b>intrepid</b> explorer	intrepid:  very brave; not afraid of danger or difficulties  勇敢的	LongTermLearning
<b>jigsaw puzzle</b>	拼图🧩	LongTermLearning
Most of the play is written in <b>verse</b>.	verse:  peotry  诗	LongTermLearning
The teacher helped them <b>tease out</b> the meaning of the poem.	tease out:  to spend time trying to find out information or the meaning of sth, especially when this is complicated or difficult  梳理清楚	LongTermLearning
<b>heuristic</b>	heuristic:  heuristic teaching or education encourages you to learn by discovering things for yourself  启发式的	LongTermLearning
<b>bizarre</b> behaviour	bizarre:  very strange or unusual  极其怪诞的	LongTermLearning
My legs were <b>trembling</b> with fear.	tremble:  to shake in a way that you cannot control, especially because you are very nervous, excited, frightened, etc  （因紧张，激动，惊慌等）颤抖	LongTermLearning
