<b>Decaying</b> standards of morality	to become less powerful and lose influence over people, society, etc. (力量，影响等) 衰落，衰退	LongTermLearning
You can throw away any <b>excess</b>.	more than is necesary, reasonable or acceptable  多余的东西	LongTermLearning
A <b>tireless</b> campaigner for human rights	不知疲倦的	LongTermLearning
In some cases, trailers improve the <b>throughput</b> of higher layer protocols by reducing the amount of data copying within the operating system.	生产量	LongTermLearning
What <b>sort of</b> music do you like?	a group or type of people or things that are similar in a particular way  种类	LongTermLearning
The situation has changed <b>somewhat</b> since we last met.	to some degree 有点，有几分	LongTermLearning
Here is an example a little bit more <b>elaborated</b>.	very complicated and detailed; carefully prepared and organized  复杂的，详尽的	LongTermLearning
The years <b>preceding</b> the war	to happen before sth or come before sth in order  先于，在...之前	LongTermLearning
She disliked him <b>intensely</b>.	非常地，强烈地	LongTermLearning
There is a <b>substantial</b> difference between declaring a normal array and allocating dynamic memory for a block of memory using new. 	large in amount, value or importance  重大的	LongTermLearning
Memory is allocated to the program and <b>reclaimed</b> by the OS in fixed-size chunks called pages.	to obtain materials from waste products so that they can be used again  回收	LongTermLearning
<b>Barring</b> accidents, we should arrive on time.	except for 除了...	LongTermLearning
 It's possible and common to <b>intermix</b> push and pop operations.	to mix things together  使混合	LongTermLearning
Nevertheless, stacks are somewhat <b>rigid</b> in that they only allow access at the top.	very strict and difficult to change  死板的	LongTermLearning
When two blocks of allocated memory are freed, they are <b>coalesced</b> to form a single block to better meet demand for larger blocks of memory. 	to come together to form one larger group, substance, etc. 合并，结合	LongTermLearning
Our farm land was <b>adjacent</b> to the river.	next to or near sth  ...毗连的，邻近的	LongTermLearning
But a heap also has advantages that <b>justify</b> the increased overhead. 	to show sb/sth is right or reasonable  证明...正确，有道理	LongTermLearning
What <b>percentage</b> of the population is overweight?	百分比	LongTermLearning
The garbage collector <b>sweeps</b> up all of the allocated memory that is still marked as garbage and returns it to the heap.	to remove sth from a surface using a brush, your hand, etc.  扫去，清除	LongTermLearning
Have you <b>observed</b> any changes lately?	to see or notice sb  观察到	LongTermLearning
<b>Asymptotic</b> analysis of an algorithm refers to defining the mathematical boundation/frame of its run-time performance.  	渐近线	LongTermLearning
A picture <b>frame</b>	（图画，门，玻璃等）框架	LongTermLearning
One of the <b>highlights</b> of the trip was seeing the Taj Mahal.	the best, most interesting or most exciting part of sth  最好的部分	LongTermLearning
On the other hand, if the CPU’s work grows <b>proportionally</b> to the input array size, you have a linear runtime O(n).	成比例的	LongTermLearning
If we <b>plot</b> the most common Big O notation examples, we would have graph like this:	to mark sth on the map  标出，画出(增加图片)	LongTermLearning
Another <b>prevalent</b> scenario is loops like for-loops or while-loops.	that exists or is very common at a particular time or in a particular place  普遍存在的，流行的	LongTermLearning
We make a guess for the solution and then we use mathematical <b>induction</b> to prove the guess is correct or incorrect. 	a method of discovering general rules and principles from particular facts and examples  归纳法	LongTermLearning
The pattern is typically a arithmetic or <b>geometric</b> series. 	几何学的	LongTermLearning
The <b>polynomial</b> <i>x^2 + y + 1<\i>	多项式	LongTermLearning
The firm has achieved a <b>dominant</b> position in the world market.	more important, powerful or noticeable than things  首要的，占支配地位的	LongTermLearning
